!!!!!!!!!
!P#.B..#!
!.#.B.B.!
!BB.BB.B!
!.B..BBE!
!....B..!
!!!!!!!!!